#######################################################
#.....................................................#
#.....................................................#
#.....................................................#
#............................^........................#
#......#####.......#.........#.......#######..........#
#..................#.........#........................#
#...#..............#.........#...........#####........#
#...#.......#......#.........#...........#............#
#####.......#......#.......###########...#......#######
#...........#####..#.......#.............#............#
#...^^^^^..................#.............#............#
#..........................#.............#............#
#......##..........#.......#.............#............#
#......##....#######.......#.............#............#
#######################################################